15
30
111111111111111111111111111111
100821000002200000000000002201
106221111112201110011111100201
152202220110001002000000110201
122020000211111100111110011001
102001102022200101100211001001
100111020020002101000211001001
100101222201002111220010001101
100101220111020112000210000001
100101101110201102112010000001
100100111012000220102011222201
100110000010222001102001200201
102010220011111111111222000201
102200022200000222201111110221
111111111111111111111111111111
