10
20
11111111111111111111
12121212122121212121
12101010100101010101
12101010100101010101
12101010150101010101
12101010100101010101
12101010100101010101
12101010100101010101
10000000000000000001
11111111111111111111
